afr-ZA	af
sqi-AL	sq
eus-ES	eu
cat-ES	ca
nld-NL	nl
eng-US	en
fin-FI	fi
fra-FR	fr
kat-GE	ka
deu-DE	de
hat-HT	ht
hun-HU	hu
isl-IS	is
ita-IT	it
jpn-JP	ja
ltz-LU	lb
mlt-MT	mt
nor-NO	no
pol-PL	pl
ron-RO	ro
rus-RU	ru
slk-SK	sk
spa-ES	es
swe-SE	sv
tha-TH	th